211011111
010010000
110011011
111010001
101110110
111010111
110010101
100111101
110001103
