211011113
010010000
110011011
111011001
101001101
111010111
110010001
101111111
111001100
