101011110
111001111
001100012
111010011
111111101
100111101
010311111
101011111
101101100