111011111
012010000
110011111
111110001
101110111
111010111
110000101
111111101
110011131
